11111111111111111111111111111111111111111111111111111111111111111111111111111
11111111111111111111111111100000000000000000000000000000000000000000000001111
11110001111111111111111111100000000000000000000000000000000000000000000001111
111100010000001P0000000000000000000000000000000000000000000000000000000001111
11110000000000010000C00000000000000000000000000000000000000000000000000001111
1111E1000000000000000C0000000000000000000000000000000000000000000000000001111
1111C100000000000000C00000000000000000000000000000000000000000000000000001111
1111C1000000000000000C0000000000000000000000000000000000000000000000000001111
111100000000000000000C0000000000000000000000000000000000000000000000000001111
11111111111111111111111111111111111111111111111111111111111111111111111111111