1111111111111111111111111111111
1001C1001001000C000000000000001
1000000010000000000000000000001
10P0E00C00101000000000000000001
1000000010111000000000000000001
1111111111111111111111111111111