1111111111111111111
1001C1001001000C001
1000E00010000000001
10P0000C00101000001
1000000010111000001
1111111111111111111
