11111111111111111111111111111111
11111111111111111111111111111111
11111111111111111111111111111111
11111000000000000000000000011111
11110001111111111111111111111111
11110001000000000000000000011111
11111111111111111111111111111111
11111111111111111111111111111111
11111111111111111111111111111111
11111111111111111111111111111111
11110001111111111111111111111111
11110001000000000000000000011111
11111111111111111111111111111111
11110000000000000000000000011111
111100000P00E000C000000000111111
111100000000000000000C0000011111
11111111111111111111111111111111
