11111111111111111111111111111111111111111111111111111111111111111111111111111
11111111111111M111111111111MMMM0M00000000000000M00000000000000000000000001M11
111100011111111M11111111111000M00M00000000000000M0000000000000000000000001111
1111MMMMMMMMMMMPMMMMMMMMMMMMMMMMMMMMMMMMC0M0CMC0M0CM0CMC0MC0M0CM0CMC0MC0M1111
1111E000000000000000C00000000000000M000000000000M0000000000000000000000001111
1111C0000000000000000C00000000000000M0000000000M00000000000000000000000001111
1111M000000000000000C0000000000000000M0000000000M0000000000000000000000001111
111100000000000000000C0000000000000000M00000000M00000000000000000000000001111
1M1100000000000000000C00000000000000000000000000000000000000000000000000011M1
11111111111111111111111111111111111111111111111111111111111111111111111111111